20 15
####################
#S                 #
# #### # #### #### #
#    # #    #    # #
#### # #### # ## # #
#    #      #    # #
# ########### #### #
#                  #
# #### #### #### # #
#    #    #    # # #
#### # ## # ## # # #
#    # #  # #  #   #
# #### ## # ## ### #
#                 G#
####################
